                  
##################
#                #
#            X   #
#  ###           #
#    #           #
#                #
#             X  #
#                #
#        ## ###  #
#    X     #     #
#                #
#                #
##################
