                  
##################
#                #
#            X   #
#                #
####             #
#                #
#             X  #
#                #
#        ###     #
#    X           #
#                #
#                #
##################
