                  
##################
#                #
#            X   #
#  ###           #
#    #           #
#                #
#             X  #
#                #
#        ##  ##  #
#    X           #
#                #
#                #
##################
