                  
##################
#                #
#    X       X   #
#                #
####             #
#                #
#      $      X  #
#                #
#                #
#    X           #
#                #
#           ######
##################
