                  
##################
#                #
#            X   #
#                #
#######          #
#           $    #
#                #
#                #
#        #########
#    X           #
#                #
#                #
##################
