                  
##################
#                #
# X              #
#                #
###########      #
#         #      #
#    $    #      #
#         #      #
#      ####      #
#                #
#                #
#                #
##################

